##A##
#CBD#
#D#D#
#IHE#
#JGF#
#K###
