###########################
#TTTTTTTTTTTTTTTTTTTTTTTTT#
#A#EGHIJLNQ#TVWYZWVXXXXXXX#
#BCDF##KMOPRSUX#YXUTX#XXX##
#UUUUUUUUUUUUUUUUUUUUUUUUU#
###########################
