###############
#.......#####.#
#######.#.#.#.#
#.............#
#.#############
#..#........###
#..####.###...#
#..#.#..#...###
#.......##....#
#############.#
#....#...#....#
#..#...#...#..#
#...#.#.#.#...#
#....#...#....#
###############

\robot 1 1
\robot 13 1
\robot 1 13
\robot 13 13