                                                                                                   
 ###############                                                                                   
 #.............#        ##############                                                             
 #.............#        #............#                                                             
 #...................   #............#             #######################################         
 #.............#    .   #............#####         #.....................................#         
 ###############    .....................#         #.....................................#         
                        #................####  ...............................############         
      ###               #...................#  .   #..........................#                    
........#               #.......................   ######################.........                 
      #.#               #####.###############                           #.....#  ..                
      #.#   ###########      .                                          #######   .................
      #.#   #.........#      .       ##################################                      .     
       ............................. #................................#                      .     
          . #.........#            . #................................#     ###############  .     
          . ###########            ...................................#     #.............#  .     
        . .                          #................................#     #.................     
        .                            #................................#     #.............#        
        .                            #................................#     #.............#        
        ..................           #........######..................#     ##.############        
                         .           #........#    #..................#       .                    
        ..................           #........#    #.....##############   .....                    
        .                            #........#    #.....#                .                        
        ......................................#    #.......................                        
             .                       #........######.....#                .   #####################
             .                       #...................##########       .   #...................#
             .                       ####.........................#       ........................#
             .                          #.........................#           #...................#
             .                          #.........................#           #...................#
             .                          ###########################           #####################
