  ############                                                                 
  #..........#                 ###########                                     
  #..............              #.........#                #########            
  #..........#                 ######.####                #.......#            
  ##########.#                       .              ..............#            
            .                        .              .     ####.####            
            .  #############         .     #########.#        .                
            .............................  #.........#        .                
               #...........#            .  #.........#        .                
               #############            .............#        .                
                                           #####.#####        .                
                                                .    #########.###             
     ###################################        .    #...........#             
     #.................................#        .................#             
     #.................................#        .    #...........#             
     #......#################..........#        .    #...........#             
     #......#               #....................    #############             
     #......#               #..........#                                       
     #......#               #..........#                                       
     #......#               #..........#                                       
     ########               ############                                       
