###############                      #################
#.............#                      #...............#
#.................               ....................#
#.............#  .               .   #...............#
###############  .               .   ##########.######
         ########.###############.########     .      
         #...............................#     .      
         #........################.......#     .      
     .............#              #..............      
         #........#              #.......#     .      
         #........################.......#     .      
         #...............................#            
         #######.###############.#########            
                .................                     
                    .         .                       
                    .         .                       
               ......         ......                  
               .                   .                  
         ######.################  #.#############     
         #.....................#  #.............#     
         #.....................#  #.............#     
         ####################.##  #.............#     
                             .    #.............#     
                             ...................#     
                                  ###############     
