  #########                                                                    
  #.......#                                                                    
  #.......#####                                #########                       
  #.......................           ..................#                       
  #######.##.##          .           .         #####.###                       
         .  .            .           .              .                          
         .  .            .           .     #########.#        .                
         .  .............................  #.........#        .                
         .            .          .       . #.........#        .                
         .            .          .      .............#        .                
         .            .          .         #####.#####        .                
         .            .          .              .    #########.###             
     ####.#########  #.##########.######        .    #...........#             
     #.................................#        .................#             
     #............#  #.................#        .    #...........#             
     #............#  #..######.........#        .    #...........#             
     #............#  #..#    #...................    #####.#######             
     #............#  #..######.........#                  .                    
     #.....................................................                    
     #............#  #.................#                                       
     ##############  ###################                                       
