########                    ###### ......          ###########     ..   #######
#......# .....  ....        #.......    .          #.........#      .   #.....#
#.........   ....  .....    #.......    .          #.........#      .   #.....#
#......#            .  .    ##.### ......          #.........#####  .   #.....#
#.######       ......... ...  .                    #.............#  .   ###.###
 .             .         . .  .                    #.............#  ...    .   
 .             ........... ....                #####.............#    ...  .   
 . #############.#     ######## ### ### ###    #...............###      ....   
 . #.............#     #......# #.# #.# #.# ####...#####.......#######     ....
 . #.............#     #......# #.# #.....# #......#   #.............###   .   
 . #.............#     #......# #.# #.# #.# #...####   #######.........### ....
 . #############.#     #......# #.....# #.# #...#            #...........# .   
 . #############.#######......# #.# #.# #.# #...#            #...........# .   
 . #..........................###.###.###.# #...#            #...........# .   
 . #......................................###...##############...........# .   
 . ##############################.###.###................................# .   
 .      ###  ...   ###  ...     #.# #....................................# .   
 . ###  #.....#.#  #.....#.#    #...#.# #########################.######## .   
 . #.#  #.#   #... #.#   #.#    #.# #.....#    .....  ........   .    .... .   
 . #.#  #.#   ###.  .    #.#    #.###.# #.# ###.###.##.##### .   .    .  . .   
 .  ......#   #.......................# ### #.................   .    .  . .   
 .      ###   #.#               #.........# #######.######## .....    .  . .   
 . .... ...   ###   ....  ...   ####### ###                           .  ......
 ...  ... ...........  .... ...........................................       .
