                                                                                                                                                    
                                                                                                                                                    
                                                                                                            ..................................      
      ######################      #########    #########      ######################      ##################.###      ###################### .      
      #....................#      #.......#    #...................................#      #....................#      #....................# .      
      #....................#      #.......#    #.......#      #....................#      #....................#      #....................# .      
      #......###############      #.......#    #.......#      #......###############      #......###############      #.......########.....# .      
      #......#                    #.......#    #.......#      #......#                    #......#                    #.........    .......# .      
      #......#                    #.......#    #.......#      #......#                    #......#                    #.......#      #.....# .      
      #......###############      #.......######.......#      #......###############      #......###############      #.......########.....# .      
      #....................#      #....................#      #....................#   ........................#      #....................# .      
      #....................#      #....................#      #.........................  #....................#      #....................# .      
      ###############......#      #.......######.......#      #......###############      #......###############      #.......######.####### .      
                    #......#      #.......#    #.......#      #......#                    #......#                    #.......#     ..........      
                    #......#      #.......#    #.......#      #......#                    #......#                    #.......#                     
      ###############......#      #....................#      #......###############      #......###############      #.......#                     
      #....................#      #.......# .. #.......#      #....................#      #....................#      #.......#                     
      #...................................# .. #.......#      #....................#      #....................#      #.......#                     
      ###########.##########      ######### .. #########      ############.#########      ##############.#######      #####.###                     
                 .                         ....                          ...                           ...                 .                        
                 ...........................  ............................ ............................. ...................                        
