                                          ##.##                         
                                          #...#                         
                                    #######...#######                   
  ##############   ##############   #...............#   ######  ######  
  #............#   #.....................###.###....#   #....#  #....#  
  #....#########   #....####....#   #....#  .  ######   #....#  #....#  
  #....#           #....#  #....#   #....###.########   #....####....#  
.......#           #....####....#   #...............#   #...............
  #....#           #............#   ########.###....#   #....####....#  
  #....#########   #....####....#   ######  .  #....#   #....#  #....#  
  #.....................#  #....#   #....###.###.............#  #....#  
  ##############   ######  ######   #...............#   ######  ######  
                                    #######...#######                   
                                          #...#                         
                                          ##.##                         
