....#######################.############################### 
   .......................................................# 
   #####################################.################.# 
..............................................          #.# 
.          ######                  .         ...............
..         #....#                  .                    ### 
 .         #....###################.###                     
 .         #..........................#                     
 .         ######..#################..#                     
 .         #..............#...........#                     
..         #...###################..###                     
.          #.##.......................#                     
.           ..............#...........#                     
.           . #######################.#                     
......................................                      
