.                 ............  
. ################.##########.  
..............................  
  #.........................#   
  #.........................#   
  ################.##########   
                  .             
