##### #####                                 
#...# #...# ........  #######               
#...###...##.####  .  #.....#               
#...............#  .  #.###.# ##########    
#####...........#  .....#  .. #...........  
    #.....###.###     #.#  #.##......### .  
    #.....#  .        ###  #.........#   .  
    #.....#  .........     ########.##  #.##
  ###.....#          .             .    #..#
  #....####          .            #.## ....#
  #....#             .            #..#..####
  #.......... ####   ...........  ####      
  ###### .  . #..#             .            
         .  .......      ####  ...........  
         .    ####.      #..#            .  
         .        .      #..#            .  
         .        .  #####..####         .  
         .  ####  .  #.........#         .  
         ......#  .  #.........#         .  
            #..#  .  #.........# .....   .  
            #..................##.## .   .  
            #..#  .  #.............# .   .  
        #####..#  .  #####...####### .   .  
        #......#  .      #...#      #.###.##
        ########         #####      #......#
                                    ########
