    .................................................................   
    .   ############################################################.###
....................#..........#..............#.............#..........#
.   .   ##########.##..........#............. #.............#..........#
.   .   #.................................... #.............#..........#
.   .   ##############.........#............. #.............#.##########
.   .   #............#.........#............. #........................#
.   .   #......#######.........#..............#........................#
.   .   ###.####...............#######..#######........................#
.   .   #...............................................#####.##########
.   .   #.##########........######################......#..............#
.   .   #..........#........#                    #......#..............#
.   .   #..........#........#                    #.....................#
.   .   #...................#                    #......#..............#
.   .   #..........#........#                    #......#..............#
.   .   #..........#........#                    #......#########......#
.   .   ############........#                    #..............#......#
.   .   #...................######################..............########
.   .   ##########.....................................................#
.   .   #........#.....................................................#
.   .   #........#..........#####.#########.####.......................#
.   .   #...................#..................#.........###.###########
.   .   #........####.......#..................#.........#.............#
.   .   #...........#.......#..................#.........#.............#
.   .   #...........#.......######........######.........#.............#
.   .   #...........#............#........#..............#.............#
.   .   ###.#########################################################.##
.   ........                                                         .  
.                                                                    .  
......................................................................   
