                                                                                                                            
           ####################                                                                                             
           #..................#                                                                                             
           #..................#                                                                                             
           #..................#                                                                                             
           #..................#                                   #######################################                   
           #.......#######....#                                   #.....................................#                   
           #.......#     #....#            ###########            #................#############........#                   
           #.......#     #....#            #.........#            #................#           #........#                   
           #.......#######....#            #.........#            #................#############........#                   
           #............................................................................................#                   
           ####################            #####.#####            #######################################                   
                                                .                                                                           
     ###################################        .                                                                           
     #.................................#        .                                                                           
     #.................................#        .                                                                           
     #......#################..........#        .                                                                           
     #......#               #....................                                                                           
     #......#               #..........#        .                                                                           
     #......#################..........#        .                                                                           
     #.................................#        .                                                                           
     ###################################        .                                                                           
                                           #####.#####            ####################                                      
                                           #.........................................#                                      
                                           #.........#            #..................#                                      
                                           #.........#            #..................#                                      
                                           ###########            #..................#                                      
                                                                  #..................#                                      
                                                                  #..................#                                      
                                                                  #..................#                                      
                                                                  #..................#                                      
                                                                  #..................#                                      
                                                                  #..................#                                      
                                                                  #..................#                                      
                                                                  #..................#                                      
                                                                  #..................#                                      
                                                                  #..................#                                      
                                                                  #..................#                                      
                                                                  #..................#                                      
                                                                  ####################                                      
