                                                                               
     #######              .............        #########################       
     #.....................           .        #.......................#       
     #.....# .       #####.#####   ###.###     #.......................#       
     #.....# .       #.........#   #.....#     #...........#######.....#       
     #.....# .       #.........#   #.......................#.....#.....#       
     #.....# .       #.........#   #.....#     #...........#...........#       
     ###.### .       #.........#   #######     #...........#.....#.....#       
  .......    .       #.....................................###.###.....#       
  .          .       #.........#   #######     #...........#.....#.....#       
##.##   #####.##     #.........#   #.....#     #...........#.....#.....#       
#...#   #......#     #.........#   #.....#     #...........#.....#.....#       
#...#   #......................#   #.....#     #############.....#######       
#...#   #####.##     #...................#                 #.....#             
#...#        .       #.........#   #.....#                 #.....#             
#...#        .       ########.##   #.....#         .....   #.....#             
#...#########.######         .     #######         .   ..........#             
#..................#   ...###.###                  .       #.....#             
#..................... . ............  ... ... .....       #######             
#..................# ...  #######   .... ... ...                               
####################                                                           
