 ..........                  ........  ###############################  
 . #######.##             ###.####  .  #.............................#  
 . #........#             #......#  .  #.............................#  
 . #........#     #########......#  .................................#  
 . #........#     #..............#     ###############.######........#  
 . ####.#####     #..............###############      .     #........#  
 .     .          #............................#      .     #........#  
 .     .    #######....................................     ####..####  
 .     .    #..................................#               #..#     
 .     ........................................##############  #..#     
 .          #............##################.................#  #..#     
 .          #............#                #.................#  #..#     
 .   ########............#                #..............####  #..#     
 .   #...................#     ######     #......#########  ......#     
 .   #...................#     #....#     #......#  .........  #..#     
 .   #...................#     #....#     #......#  .    #######..#     
 .   ##############......#######....#######......#  .    #........#     
 .                #..............................#  .    #........#     
 .   ##############...........................####  .    ##########     
 .   #........................................#     .                   
 .   #........................................#     .......             
 .   #.....#############..........#########...####        .....         
 .   #.....#  #######  #..........#       #......#            .         
 .   ##.####  #.....#  #...............   #......#            .         
 .     .      #...................#   .   #####..#########    .         
 .     . ######.....#  #..........#   .       #..........#    .         
 .     .............#  ############   .       #####......#    .         
 .       ############                 .           #............         
 ......................................           ########              
                                                                        
