##############                                    
#............#              ##################    
#....................       #................#    
#............#      .       #..........#######    
#............#      ...................#          
#............#      .       #..........#          
#............#######.#####  #####.######          
#........................#       .                
#........................#       .                
#........................#       .  ###########   
###.######################       .  #.........#   
   .                             .  #.........#   
###.###################          .  ########.##   
#.................................          .     
#.....................#          .          .     
#.....................#          .          .     
#.....................#          ........   .     
#.....................#                 .   .     
########.##############                 .....     
        .                               .         
        .                               .         
        .................................         
                      .                           
######################.#########################  
#..............................................#  
#..............................................#  
#..............................................#  
################################################  
