      ################             ################ 
      #..............#             #..............# 
      #...........................................# 
      #..............#             #..............# 
      ################             ###.#######.#### 
                                      .       .     
                    ...........................     
                    .                 .    ###.#####
             #######.#########        .    #.......#
             #...............#        .    ######.##
             #...............#        .          .  
             #...............#        .          .. 
             #.......#######.#        .           . 
             #.......#     #....................  . 
             #.......#     #.#                 .  . 
             #.....###  ####.#                 .  . 
             #.....#    #....#                 .  . 
             #.....#    #....#                 .  . 
             #.....#    #....#                 .  . 
             #.....######....#                 .  . 
             #...............#                 .  . 
             #...............#                 .  . 
             #...............#                 .  . 
             #################                    . 
                                                  . 
  #######################                         . 
  #.....................#                         . 
  #................................................ 
  #.....................#                           
  #.....................#                           
  #.....................#                           
  #######################                           
