

                                                                                               
   ############################################################################################
   #..........................................................................................#
   #..........................................................................................#
   #..........................................................................................#
   #..........................................#############...........##################......#
   #..........................................#           #...........#                #......#
   ########################...................#           #...........#                #......#
                          #....#########......#           #...........#                #......#
                          #....#       #......#           #...........##################......#
                          #....#       #......#           #...................................#
                          #....#       #......#           #####################################
                          #....#########......#                                                
                          #...................#                                                
                          #####################                                                
