  ############                                                                   ############                                                     
  #..........#                 ###########                                       #..........#                 ###########                         
  #..............              #.........#                #########      ...................#                 #.........#                #########
  #..........#                 ######.####                #...............       #..........#                 ######.####                #.......#
  ##########.#                       .              ..............#              ##########.#                       .              ..............#
            .                        .              .     ####.####                        .                        .              .     ####.####
            .  #############         .     #########.#        .                            .  #############         .     #########.#        .    
            .............................  #.........#        .                            .............................  #.........#        .    
               #...........#            .  #.........#        ..............................  #...........#            .  #.........#        .    
               #############            .............#        .                               #############            .............#        .    
                                           #####.#####        .                                                           #####.#####        .    
                                                .    #########.###                                                             .    #########.### 
     ###################################        .    #...........#                  ###################################        .    #...........# 
     #.................................#        .................#                  #.................................#        .................# 
     #.................................#        .    #...........#                  #.................................#        .    #...........# 
     #......####.############..........#        .    #.....................................#################..........#        .    #...........# 
     #......#   .           #....................    #############         .        #......#               #....................    ############# 
     #......#   .           #..........#                                   .        #......#               #..........#     .                     
     #......#   .           #..........#                                   .        #......#################..........#     .                     
     #......#   .           #..........#                                   .        #.................................#     .                     
     ########   .           ############                                   .        ###################################     .                     
  ############  .                                                          .     ############                               .                     
  #..........#  .              ###########                               ...................#                 ###########   .                     
  #..............              #.........#                #########      .       #..............              #..............            #########
  #..........#                 ######.####                #...............       #..........#                 ######.####                #.......#
  ##########.#                       .              ..............#              ##########.#                       .              ..............#
            .                        .              .     ####.####                        .                        .              .     ####.####
            .  #############         .     #########.#        .                            .  #############         .     #########.#        .    
            .............................  #.........#        .                            .............................  #.........#        .    
               #...........#            .  #.........#        .                               #...........#            .  #.........#        .    
               #############            .............#        .                               #############            .............#        .    
                                           #####.#####        .                                                           #####.#####        .    
                                                .    #########.###                                                             .    #########.### 
     ###################################        .    #...........#                  ###################################        .    #...........# 
     #.................................#        ......................................................................#        .................# 
     #.................................#        .    #...........#                  #.................................#        .    #...........# 
     #......#################..........#        .    #...........#                  #......#################..........#        .    #...........# 
     #......#               #....................    #############                  #......#               #....................    ############# 
     #......#               #..........#                                            #......#               #..........#                           
     #......#               #..........#                    ...............................#################..........#                           
     #......#               #................................                       #.................................#                           
     ########               ############                                            ###################################                           
