  ############################                
  #..........................#  #######       
  #..........................#  #.....#       
  #..........................#  ####.##       
  #..........................#      .         
  #..........................#      .         
  #.......................................    
  #..........................#           .    
  ############################           .    
                                         .    
                               ##########.####
                               #.............#
                               #.............#
                               #.............#
                               ###############