                                                                 
    ###############                  ########################    
    #.............#                  #......................#    
    #....#####....#         ................................#    
    #....#   #....#         .        #......................#    
    #....#####....#         .        #......................#    
    #.............#         .        #......................#    
    #.............................   ########.###############    
    #....#####....#        .                 .                   
    #....#   #....#        .                 .                   
    #....#####....#        .                 ..........          
    #.............#        .                          .          
    #########.#####        .                 #########.##########
             .             .                 #..................#
             ...................................................#
             .         .                     #..................#
             .         .      ########       #..................#
             .         ...... #......#       #..................#
             .         .    .........#       #..................#
             ...........      #......#       #..................#
                       .      #......#       #..................#
                       .      ########       ####################
                       .                                         
        ###############.#############################            
        #...........................................#            
        #...........................................#            
        #...........................................#            
        #.............###################...........#            
        #.............#                 #...........#            
        #.............#            ######...........#            
        #.............#            #................#            
        #.............#   ##########................#            
        #.............#   #.........................#            
        ###############   #.........................#            
                          ###########################            
