  ############
  #..........#
  #..........#
  ##.#########
    .         
    .         
    .         
  ##.#########
  #..........#
  #..........#
  ############
