 ##############################                                      
 #............................#                                      
 #...#######..................#               #########              
 #...#     #...#########......#               #.......#              
 #...#     #...#       #......#######         #.......#              
 #####     #...#       #..............................#              
           ##.##       #............#         #.......#              
             .         #......#######         #.......#      ####### 
             .         #......#               #.......#      #.....# 
      #######.##########......#               #.......#      #.....# 
      #.......................#               #.......#      #.....##
      #................................       #.......########......#
      ##########.##############       .       #.....................#
                .                     ..............................#
                .                             #######################
      ##########.#########                                           
      #..................#                                           
      #......######......#                                           
      #......#    #......#                                           
      #......#    #......#                                           
      #......######......#                                           
      #..................#                                           
      #.............######                                           
      #.............#                                                
      #.....######..###                                              
      #.....#    #....#                                              
      #.....#    ###..###                                            
      #.....#      #....#                                            
      #.....#      ###..###                                          
      #.....#        #....#                                          
      #.....#        ###..###                                        
      #.....#          #....#                                        
      #######          ######                                        
